0x00000000 vc900066.vox
0x00007800 vc900067.vox
0x0000f000 vc900068.vox
0x00019800 vc900069.vox
0x00021800 vc900071.vox
0x00026000 vc900072.vox
0x0002c800 vc900080.vox
0x00033800 vc900081.vox
0x0003e800 vc900082.vox
0x00048000 vc900083.vox
0x00050800 vc900084.vox
0x00057000 vc900085.vox
0x0005c000 vc900021.vox
