0x00000000 vc070002
0x001d8000 vc070003
0x003fb000 vc070004
0x0061e000 vc070005
0x008a4800 vc070006
0x00b1d800 vc070007
0x00d43800 vc070008
0x00fcd000 vc070009
0x01238800 vc070010
0x01483000 vc070011
0x01670800 vc070012
0x01951000 vc070015
0x01c3c800 vc070016
0x01ef8000 vc070017
0x02295800 vc070018
0x025e1800 vc070019
0x0292d800 vc070020
0x02cb2000 vc070021
0x030e2800 vc070022
0x03539800 vc070023
0x037b3800 vc070024
0x03aad000 vc070025
0x03de4800 vc070026
0x04136800 vc070029
0x0444d000 vc070030
0x0467f000 vc070031
0x049ed000 vc070100
0x04aea000 vc070101
0x04b63000 vc070102
0x04be9000 vc070103
0x04c46000 vc070104
0x04cc0000 vc070105
0x04d22000 vc070106
0x04d8a000 vc070107
0x04e7d000 vc070108
0x04f26800 vc070110
0x0502e000 vc070111
0x050b8800 vc070112
0x0513c000 vc070113
0x051bb800 vc070114
0x053d6000 vc070121
0x0545b800 vc070122
0x054d2000 vc070123
0x05545000 vc070130
0x0570e000 vc070132
0x05a1f000 vc070133
0x0601d000 vc070134
0x063b4800 vc070135
0x06595800 vc070136
0x067dc000 vc070137
0x069a2800 vc070138
0x06be4800 vc070139
0x06cf7000 vc070140
0x06de2800 vc070144
0x070d9000 vc070200
0x07bac000 rmv001
0x07f9a800 vc003507
0x081ae800 vc110107
0x082a8000 vc110111
0x08390000 vc110304
0x08488000 vc080402
0x0862f000 vc080404
0x087bd800 vc080102
0x089c0000 vc110902
0x08bc5800 vc110802
0x08e8b800 vc110407
0x09237000 vc114702
0x09425800 vc260771
0x09565800 vc266521
0x096ff800 vc266611
0x098f6800 vc266641
0x09d02000 vc261722
0x09ea2800 vc112408
0x09f31800 vc117102
0x0a1d3000 p010_06_m02
0x0b510800 p014_02_m01
0x0bea6000 p014_04_m02
0x0c9b7000 p014_07_m03
0x0dd7a800 p049_04_m02
0x0eec9800 p049_06_m03
0x0f96b000 p049_09_m05
0x10a8f000 p055_03_m01
0x11eb1000 p059_02_m02
0x12da0000 p010_02_m01
0x13e9c800 p010_07_m03
0x146f7800 p010_08_m04
0x14f4e000 p014_14_m04
0x156be800 p036_09_m01
0x15b2b000 p040_06_r02
0x16116000 p049_07_m04
0x16ea2800 p050_03_m02
0x17cb4800 p050_05_m03
0x19ed9000 p058_05_m01
0x1a745000 p062_02_m01
0x1b664800 p062_04_m02
0x1bed7000 p070_06_m01
0x1c1ff000 p070_11_m02
0x1cc1c800 p070_14_m03
0x1d7ce000 p070_19_m05
0x1dff9800 p080_02_m01
0x1e649000 p080_22_m09
0x1ef8c000 p080_24_m10
